11111111111111111111
1P0C00C000000C00C001
11111111111111111101
1C0000000000000000C1
10111111111111111111
10000000000000000001
10000101100011100001
10001101100110110001
10011001100100011001
10111111100000110001
10000001100001100001
10000001100011000001
10000001100111111001
10000000000000000001
10000000000000000001
11111111111111111001
10000C00000000C00001
10011111111111111111
1000000C0000000000E1
11111111111111111111
